Booking.date,Credit,Debit,Balance
02.11.2024,,100,72803
30.10.2024,,10,72903
30.10.2024,,,72913
30.10.2024,,,72913
30.10.2024,,,72913
30.10.2024,,,72913
30.10.2024,,,72913
30.10.2024,,,72913
30.10.2024,,,72913
30.10.2024,,,72913
30.10.2024,,,72913
28.10.2024,,800,72913
27.10.2024,,295,74513
27.10.2024,,70,74808
26.10.2024,,100,74878
23.10.2024,4999,,74978
19.10.2024,,70,69979
09.10.2024,,,70049
09.10.2024,,,70049
09.10.2024,,,70049
09.10.2024,,300,70049
08.10.2024,,,70349
07.10.2024,,5,70349
30.09.2024,,10,70354
30.09.2024,,,70364
30.09.2024,,,70364
30.09.2024,,,70364
30.09.2024,,,70364
30.09.2024,,,70364
30.09.2024,,,70364
30.09.2024,,,70364
30.09.2024,,10,70364
30.09.2024,,5,70374
28.09.2024,,800,70379
25.09.2024,4999,,71979
24.09.2024,,45,66980
24.09.2024,,10,67025
23.09.2024,,5,67035
23.09.2024,,5,67040
22.09.2024,,295,67045
21.09.2024,,35,67340
21.09.2024,,10,67375
17.09.2024,,5,67385
16.09.2024,,85,67390
15.09.2024,,35,67475
04.09.2024,,130,67510
31.08.2024,,10,67640
31.08.2024,,10,67650
31.08.2024,,,67660
31.08.2024,,,67660
31.08.2024,,,67660
31.08.2024,,,67660
31.08.2024,,,67660
31.08.2024,,,67660
31.08.2024,,,67660
31.08.2024,,,67660
31.08.2024,,,67660
28.08.2024,,800,67660
27.08.2024,,70,69260
26.08.2024,,5,69330
25.08.2024,4999,,69335
24.08.2024,,105,64336
24.08.2024,,35,64441
21.08.2024,,295,64476
20.08.2024,,15,64771
20.08.2024,,5,64786
20.08.2024,,5,64791
19.08.2024,,5,64796
18.08.2024,,10,64801
17.08.2024,,100,64811
14.08.2024,,5,64911
12.08.2024,,350,64916
12.08.2024,,15,65266
12.08.2024,,5,65281
12.08.2024,,5,65286
07.08.2024,,90,65291
07.08.2024,,80,65381
06.08.2024,,50,65461
06.08.2024,,15,65511
05.08.2024,,350,65526
05.08.2024,,25,65876
04.08.2024,,45,65901
04.08.2024,,25,65946
04.08.2024,,5,65971
31.07.2024,,100,65976
31.07.2024,,40,66076
31.07.2024,,10,66116
31.07.2024,,,66126
31.07.2024,,,66126
31.07.2024,,,66126
31.07.2024,,,66126
31.07.2024,,,66126
31.07.2024,,,66126
31.07.2024,,,66126
31.07.2024,,5,66126
30.07.2024,,5,66131
29.07.2024,,5,66136
29.07.2024,,5,66141
28.07.2024,,800,66146
27.07.2024,,400,67746
27.07.2024,,5,68146
24.07.2024,,100,68151
24.07.2024,4999,,68251
23.07.2024,,295,63252
23.07.2024,,5,63547
22.07.2024,,5,63552
22.07.2024,,5,63557
21.07.2024,,25,63562
21.07.2024,,25,63587
20.07.2024,,75,63612
20.07.2024,,20,63687
20.07.2024,,5,63707
16.07.2024,,65,63712
16.07.2024,,5,63777
15.07.2024,,25,63782
15.07.2024,,10,63807
15.07.2024,,5,63817
15.07.2024,,5,63822
03.07.2024,,90,63827
03.07.2024,,15,63917
02.07.2024,,55,63932
02.07.2024,,20,63987
01.07.2024,,10,64007
30.06.2024,,10,64017
30.06.2024,,,64027
30.06.2024,,,64027
30.06.2024,,,64027
30.06.2024,,,64027
30.06.2024,,,64027
30.06.2024,,,64027
30.06.2024,,,64027
26.06.2024,,800,64027
25.06.2024,,295,65627
25.06.2024,4999,,65922
24.06.2024,,55,60923
24.06.2024,,50,60978
24.06.2024,,40,61028
24.06.2024,,5,61068
22.06.2024,,230,61073
22.06.2024,,25,61303
15.06.2024,,90,61328
15.06.2024,,35,61418
15.06.2024,,5,61453
08.06.2024,,60,61458
02.06.2024,,295,61518
01.06.2024,,5,61813
29.05.2024,,10,61818
29.05.2024,,,61828
29.05.2024,,,61828
29.05.2024,,,61828
29.05.2024,,,61828
29.05.2024,,,61828
28.05.2024,,800,61828
25.05.2024,,80,63428
25.05.2024,,20,63508
25.05.2024,4999,,63528
15.05.2024,,95,58529
11.05.2024,,10,58624
08.05.2024,,65,58634
08.05.2024,,30,58699
30.04.2024,,110,58729
30.04.2024,,10,58839
30.04.2024,,,58849
30.04.2024,,,58849
30.04.2024,,,58849
30.04.2024,,,58849
30.04.2024,,,58849
30.04.2024,,,58849
30.04.2024,,,58849
28.04.2024,,800,58849
27.04.2024,,295,60449
27.04.2024,,70,60744
24.04.2024,4999,,60814
23.04.2024,,5,55815
21.04.2024,,295,55820
21.04.2024,,90,56115
09.04.2024,,365,56205
06.04.2024,,800,56570
31.03.2024,,10,57370
31.03.2024,,,57380
31.03.2024,,,57380
31.03.2024,,,57380
31.03.2024,,,57380
31.03.2024,,,57380
31.03.2024,,,57380
31.03.2024,,,57380
30.03.2024,,295,57380
27.03.2024,,800,57675
25.03.2024,4999,,59275
24.03.2024,,110,54276
23.03.2024,,295,54386
11.03.2024,,5,54681
09.03.2024,,15,54686
09.03.2024,,5,54701
06.03.2024,,400,54706
04.03.2024,,200,55106
03.03.2024,,5,55306
02.03.2024,,25,55311
28.02.2024,,800,55336
28.02.2024,,10,56936
28.02.2024,,10,56946
28.02.2024,,,56956
28.02.2024,,,56956
28.02.2024,,,56956
28.02.2024,,,56956
28.02.2024,,,56956
28.02.2024,,,56956
28.02.2024,,,56956
28.02.2024,,,56956
28.02.2024,,,56956
28.02.2024,,,56956
26.02.2024,,15,56956
26.02.2024,,5,56971
26.02.2024,,5,56976
25.02.2024,,270,56981
25.02.2024,,5,57251
25.02.2024,,5,57256
25.02.2024,4999,,57261
24.02.2024,,20,52262
24.02.2024,,5,52282
21.02.2024,,5,52287
20.02.2024,,500,52292
19.02.2024,,5,52792
19.02.2024,,5,52797
17.02.2024,,80,52802
17.02.2024,,45,52882
17.02.2024,,10,52927
11.02.2024,,40,52937
11.02.2024,,35,52977
11.02.2024,,30,53012
11.02.2024,,20,53042
10.02.2024,,20,53062
10.02.2024,,20,53082
07.02.2024,,30,53102
05.02.2024,,3280,53132
05.02.2024,,5,56412
04.02.2024,,5,56417
03.02.2024,,200,56422
03.02.2024,,80,56622
03.02.2024,,25,56702
03.02.2024,,10,56727
31.01.2024,,25,56737
31.01.2024,,10,56762
31.01.2024,,,56772
31.01.2024,,,56772
31.01.2024,,,56772
31.01.2024,,,56772
31.01.2024,,,56772
31.01.2024,,5,56772
29.01.2024,,5,56777
29.01.2024,,5,56782
29.01.2024,,5,56787
28.01.2024,,800,56792
27.01.2024,,15,58392
24.01.2024,,5,58407
24.01.2024,,5,58412
24.01.2024,4999,,58417
22.01.2024,,5,53418
20.01.2024,,60,53423
20.01.2024,,45,53483
20.01.2024,,25,53528
15.01.2024,,15,53553
15.01.2024,,5,53568
14.01.2024,,10,53573
13.01.2024,,55,53583
13.01.2024,,15,53638
13.01.2024,,5,53653
13.01.2024,,5,53658
13.01.2024,,5,53663
13.01.2024,,5,53668
10.01.2024,,5,53673
10.01.2024,,5,53678
09.01.2024,,5,53683
09.01.2024,,5,53688
06.01.2024,,25,53693
02.01.2024,,10,53718
31.12.2023,,10,53728
31.12.2023,,,53738
31.12.2023,,,53738
31.12.2023,,,53738
31.12.2023,,,53738
31.12.2023,,,53738
31.12.2023,,,53738
31.12.2023,,,53738
31.12.2023,,,53738
31.12.2023,,,53738
27.12.2023,,800,53738
27.12.2023,,115,55338
27.12.2023,,20,55453
27.12.2023,,5,55473
26.12.2023,,160,55478
26.12.2023,,90,55638
26.12.2023,,90,55728
24.12.2023,,295,55818
24.12.2023,,65,56113
24.12.2023,,55,56178
24.12.2023,,25,56233
23.12.2023,,75,56258
23.12.2023,,,56333
23.12.2023,4999,,56333
20.12.2023,,20,51334
20.12.2023,,5,51354
19.12.2023,,335,51359
19.12.2023,,295,51694
19.12.2023,,235,51989
18.12.2023,,55,52224
17.12.2023,,475,52279
17.12.2023,,105,52754
17.12.2023,,50,52859
17.12.2023,,5,52909
17.12.2023,,5,52914
16.12.2023,,85,52919
16.12.2023,,20,53004
16.12.2023,,5,53024
16.12.2023,,,53029
13.12.2023,,145,53029
13.12.2023,,5,53174
13.12.2023,,5,53179
12.12.2023,,10,53184
10.12.2023,,5,53194
10.12.2023,,5,53199
10.12.2023,,5,53204
09.12.2023,,45,53209
09.12.2023,,25,53254
05.12.2023,,105,53279
05.12.2023,,10,53384
05.12.2023,,5,53394
05.12.2023,,5,53399
04.12.2023,,5,53404
04.12.2023,,5,53409
03.12.2023,,110,53414
03.12.2023,,10,53524
03.12.2023,,5,53534
02.12.2023,,600,53539
02.12.2023,,285,54139
02.12.2023,,45,54424
29.11.2023,,10,54469
29.11.2023,,,54479
29.11.2023,,,54479
29.11.2023,,,54479
29.11.2023,,,54479
29.11.2023,,,54479
29.11.2023,,,54479
29.11.2023,,,54479
29.11.2023,,5,54479
28.11.2023,,800,54484
28.11.2023,,10,56084
28.11.2023,,5,56094
27.11.2023,,260,56099
27.11.2023,,5,56359
26.11.2023,,5,56364
26.11.2023,,5,56369
25.11.2023,,10,56374
25.11.2023,,10,56384
25.11.2023,4999,,56394
21.11.2023,,20,51395
21.11.2023,,5,51415
21.11.2023,,5,51420
20.11.2023,,15,51425
19.11.2023,,5,51440
18.11.2023,,400,51445
18.11.2023,,10,51845
18.11.2023,,5,51855
18.11.2023,,5,51860
18.11.2023,,5,51865
15.11.2023,,5,51870
14.11.2023,,5,51875
13.11.2023,,10,51880
11.11.2023,,35,51890
11.11.2023,,20,51925
08.11.2023,,375,51945
08.11.2023,,5,52320
06.11.2023,,300,52325
06.11.2023,,200,52625
06.11.2023,,20,52825
06.11.2023,,5,52845
05.11.2023,,55,52850
05.11.2023,,5,52905
04.11.2023,,30,52910
04.11.2023,,10,52940
04.11.2023,,10,52950
01.11.2023,,5,52960
01.11.2023,,5,52965
31.10.2023,,10,52970
31.10.2023,,,52980
31.10.2023,,,52980
31.10.2023,,,52980
31.10.2023,,,52980
31.10.2023,,,52980
30.10.2023,,5,52980
29.10.2023,,5,52985
28.10.2023,,30,52990
28.10.2023,,5,53020
28.10.2023,,5,53025
25.10.2023,4999,,53030
24.10.2023,,20,48031
24.10.2023,,5,48051
23.10.2023,,5,48056
23.10.2023,,5,48061
21.10.2023,,30,48066
21.10.2023,,5,48096
21.10.2023,,5,48101
18.10.2023,,5,48106
16.10.2023,,260,48111
16.10.2023,,5,48371
15.10.2023,,5,48376
14.10.2023,,4800,48381
14.10.2023,,335,53181
14.10.2023,,75,53516
14.10.2023,,55,53591
14.10.2023,,20,53646
14.10.2023,,10,53666
11.10.2023,,5,53676
08.10.2023,,35,53681
07.10.2023,,70,53716
07.10.2023,,45,53786
07.10.2023,,30,53831
04.10.2023,,5,53861
02.10.2023,,10,53866
01.10.2023,,10,53876
01.10.2023,,5,53886
30.09.2023,,2000,53891
30.09.2023,,25,55891
30.09.2023,,15,55916
30.09.2023,,10,55931
30.09.2023,,,55941
30.09.2023,,,55941
30.09.2023,,,55941
30.09.2023,,,55941
30.09.2023,,,55941
30.09.2023,,,55941
30.09.2023,,,55941
30.09.2023,,5,55941
30.09.2023,,5,55946
30.09.2023,,5,55951
30.09.2023,,5,55956
27.09.2023,,20,55961
26.09.2023,,100,55981
25.09.2023,4999,,56081
23.09.2023,,220,51082
23.09.2023,,5,51302
23.09.2023,,5,51307
23.09.2023,4999,,51312
20.09.2023,,260,46313
19.09.2023,,15,46573
19.09.2023,,5,46588
17.09.2023,,10,46593
17.09.2023,,5,46603
17.09.2023,,5,46608
17.09.2023,,5,46613
16.09.2023,,335,46618
16.09.2023,,100,46953
16.09.2023,,80,47053
16.09.2023,,65,47133
13.09.2023,,5,47198
12.09.2023,,40,47203
10.09.2023,,5,47243
09.09.2023,,5,47248
09.09.2023,,5,47253
06.09.2023,,10,47258
04.09.2023,,5,47268
04.09.2023,,5,47273
03.09.2023,,245,47278
03.09.2023,,195,47523
03.09.2023,,190,47718
03.09.2023,,20,47908
03.09.2023,,10,47928
02.09.2023,,50,47938
02.09.2023,,25,47988
30.08.2023,,15,48013
30.08.2023,,15,48028
30.08.2023,,10,48043
30.08.2023,,,48053
30.08.2023,,,48053
30.08.2023,,,48053
30.08.2023,,,48053
30.08.2023,,,48053
30.08.2023,,,48053
30.08.2023,,,48053
30.08.2023,,5,48053
30.08.2023,,5,48058
30.08.2023,,5,48063
29.08.2023,,500,48068
28.08.2023,,60,48568
28.08.2023,,15,48628
28.08.2023,,10,48643
27.08.2023,,25,48653
27.08.2023,,5,48678
27.08.2023,,5,48683
27.08.2023,,5,48688
26.08.2023,,120,48693
26.08.2023,,50,48813
26.08.2023,,5,48863
23.08.2023,,20,48868
23.08.2023,,5,48888
23.08.2023,,5,48893
23.08.2023,4999,,48898
21.08.2023,,50,43899
21.08.2023,,5,43949
21.08.2023,,5,43954
20.08.2023,,20,43959
20.08.2023,,10,43979
19.08.2023,,260,43989
19.08.2023,,45,44249
16.08.2023,,335,44294
16.08.2023,,40,44629
16.08.2023,,5,44669
15.08.2023,,15,44674
15.08.2023,,5,44689
14.08.2023,,35,44694
14.08.2023,,5,44729
13.08.2023,,25,44734
12.08.2023,,160,44759
12.08.2023,,20,44919
12.08.2023,,10,44939
12.08.2023,,5,44949
12.08.2023,,5,44954
12.08.2023,,5,44959
12.08.2023,,5,44964
09.08.2023,,5,44969
09.08.2023,,5,44974
09.08.2023,,5,44979
08.08.2023,,5,44984
08.08.2023,,5,44989
07.08.2023,,5,44994
06.08.2023,,500,44999
06.08.2023,,200,45499
06.08.2023,,5,45699
06.08.2023,,5,45704
05.08.2023,,100,45709
05.08.2023,,50,45809
05.08.2023,,15,45859
05.08.2023,,10,45874
05.08.2023,,5,45884
31.07.2023,,45,45889
31.07.2023,,15,45934
31.07.2023,,10,45949
31.07.2023,,,45959
31.07.2023,,,45959
31.07.2023,,,45959
31.07.2023,,,45959
31.07.2023,,,45959
31.07.2023,,5,45959
30.07.2023,,5,45964
30.07.2023,,5,45969
29.07.2023,,20,45974
29.07.2023,,10,45994
29.07.2023,,10,46004
26.07.2023,,10,46014
26.07.2023,,5,46024
25.07.2023,,5,46029
25.07.2023,4999,,46034
22.07.2023,,35,41035
22.07.2023,,5,41070
22.07.2023,,5,41075
19.07.2023,,5,41080
18.07.2023,,5,41085
17.07.2023,,260,41090
17.07.2023,,120,41350
17.07.2023,,5,41470
15.07.2023,,85,41475
15.07.2023,,10,41560
15.07.2023,,10,41570
12.07.2023,,5,41580
11.07.2023,,60,41585
10.07.2023,,5,41645
10.07.2023,,5,41650
09.07.2023,,335,41655
09.07.2023,,5,41990
08.07.2023,,50,41995
08.07.2023,,10,42045
08.07.2023,,5,42055
05.07.2023,,5,42060
04.07.2023,,30,42065
02.07.2023,,5,42095
02.07.2023,,5,42100
01.07.2023,,335,42105
01.07.2023,,260,42440
01.07.2023,,40,42700
28.06.2023,,25,42740
28.06.2023,,5,42765
28.06.2023,,5,42770
28.06.2023,,,42775
28.06.2023,,,42775
28.06.2023,,,42775
28.06.2023,,,42775
28.06.2023,,,42775
28.06.2023,,,42775
28.06.2023,,,42775
28.06.2023,,,42775
27.06.2023,,80,42775
27.06.2023,,10,42855
27.06.2023,,5,42865
26.06.2023,,50,42870
25.06.2023,,70,42920
25.06.2023,,40,42990
25.06.2023,,5,43030
25.06.2023,,5,43035
25.06.2023,4999,,43040
24.06.2023,,25,38041
24.06.2023,,10,38066
24.06.2023,,10,38076
21.06.2023,,105,38086
19.06.2023,,1500,38191
14.06.2023,,400,39691
12.06.2023,,10,40091
11.06.2023,,25,40101
11.06.2023,,5,40126
11.06.2023,,5,40131
10.06.2023,,300,40136
10.06.2023,,105,40436
10.06.2023,,50,40541
10.06.2023,,10,40591
10.06.2023,,10,40601
10.06.2023,,10,40611
10.06.2023,,5,40621
06.06.2023,,40,40626
05.06.2023,,5,40666
04.06.2023,,5,40671
03.06.2023,,55,40676
03.06.2023,,5,40731
03.06.2023,,5,40736
31.05.2023,,5,40741
31.05.2023,,,40746
31.05.2023,,,40746
31.05.2023,,,40746
31.05.2023,,,40746
31.05.2023,,,40746
31.05.2023,,,40746
30.05.2023,,5,40746
30.05.2023,,5,40751
28.05.2023,,10,40756
27.05.2023,,5,40766
24.05.2023,,10,40771
24.05.2023,4999,,40781
21.05.2023,,260,35782
21.05.2023,,5,36042
20.05.2023,,135,36047
20.05.2023,,55,36182
20.05.2023,,30,36237
20.05.2023,,10,36267
20.05.2023,,5,36277
17.05.2023,,5,36282
16.05.2023,,55,36287
15.05.2023,,40,36342
15.05.2023,,20,36382
13.05.2023,,55,36402
13.05.2023,,50,36457
13.05.2023,,45,36507
13.05.2023,,5,36552
13.05.2023,,5,36557
10.05.2023,,340,36562
10.05.2023,,5,36902
09.05.2023,,5,36907
08.05.2023,,5,36912
07.05.2023,,20,36917
07.05.2023,,15,36937
07.05.2023,,5,36952
11.05.2023,,50,36957
11.05.2023,,55,37007
13.05.2023,,45,37062
13.05.2023,,5,37107
13.05.2023,,5,37112
10.05.2023,,340,37117
10.05.2023,,5,37457
09.05.2023,,5,37462
08.05.2023,,5,37467
07.05.2023,,20,37472
07.05.2023,,15,37492
07.05.2023,,5,37507
06.05.2023,,65,37512
06.05.2023,,40,37577
06.05.2023,,35,37617
06.05.2023,,20,37652
06.05.2023,,20,37672
06.05.2023,,5,37692
06.05.2023,,5,37697
06.05.2023,,5,37702
03.05.2023,,5,37707
02.05.2023,,45,37712
01.05.2023,,5,37757
30.04.2023,,5,37762
30.04.2023,,5,37767
30.04.2023,,5,37772
30.04.2023,,5,37777
30.04.2023,,,37782
30.04.2023,,,37782
30.04.2023,,,37782
30.04.2023,,,37782
30.04.2023,,,37782
30.04.2023,,,37782
29.04.2023,,55,37782
29.04.2023,,25,37837
26.04.2023,,120,37862
26.04.2023,,5,37982
26.04.2023,,5,37987
25.04.2023,4999,,37992
24.04.2023,,5,32993
22.04.2023,,95,32998
22.04.2023,,50,33093
22.04.2023,,10,33143
18.04.2023,,15,33153
18.04.2023,,5,33168
17.04.2023,,40,33173
17.04.2023,,5,33213
16.04.2023,,260,33218
16.04.2023,,40,33478
16.04.2023,,30,33518
16.04.2023,,20,33548
16.04.2023,,5,33568
16.04.2023,,5,33573
16.04.2023,,5,33578
15.04.2023,,55,33583
15.04.2023,,30,33638
12.04.2023,,40,33668
12.04.2023,,5,33708
12.04.2023,,5,33713
11.04.2023,,5,33718
11.04.2023,,5,33723
09.04.2023,,5,33728
09.04.2023,,5,33733
08.04.2023,,340,33738
08.04.2023,,75,34078
08.04.2023,,10,34153
08.04.2023,,5,34163
03.04.2023,,5,34168
03.04.2023,,5,34173
01.04.2023,,30,34178
01.04.2023,,20,34208
01.04.2023,,5,34228
01.04.2023,,5,34233
01.04.2023,,5,34238
29.03.2023,,5,34243
29.03.2023,,5,34248
29.03.2023,,5,34253
29.03.2023,,,34258
29.03.2023,,,34258
29.03.2023,,,34258
29.03.2023,,,34258
29.03.2023,,,34258
29.03.2023,,,34258
28.03.2023,,5,34258
26.03.2023,,5,34263
26.03.2023,,5,34268
25.03.2023,,195,34273
25.03.2023,,80,34468
25.03.2023,,25,34548
25.03.2023,,5,34573
25.03.2023,4999,,34578
22.03.2023,,5,29579
20.03.2023,,5,29584
20.03.2023,,5,29589
19.03.2023,,365,29594
19.03.2023,,340,29959
19.03.2023,,315,30299
19.03.2023,,260,30614
18.03.2023,,35,30874
18.03.2023,,30,30909
18.03.2023,,5,30939
14.03.2023,,5,30944
14.03.2023,,5,30949
13.03.2023,,35,30954
12.03.2023,,5,30989
12.03.2023,,5,30994
11.03.2023,,65,30999
08.03.2023,,45,31064
07.03.2023,,10,31109
06.03.2023,,5,31119
05.03.2023,,5,31124
05.03.2023,,5,31129
04.03.2023,,75,31134
04.03.2023,,50,31209
04.03.2023,,15,31259
04.03.2023,,10,31274
04.03.2023,,5,31284
01.03.2023,,15,31289
01.03.2023,,5,31304
28.02.2023,,20,31309
28.02.2023,,10,31329
28.02.2023,,5,31339
28.02.2023,,,31344
28.02.2023,,,31344
28.02.2023,,,31344
28.02.2023,,,31344
28.02.2023,,,31344
28.02.2023,,,31344
28.02.2023,,,31344
28.02.2023,,,31344
28.02.2023,,,31344
28.02.2023,,,31344
28.02.2023,,,31344
26.02.2023,,5,31344
25.02.2023,,20,31349
25.02.2023,,20,31369
25.02.2023,4999,,31389
21.02.2023,,15,26390
20.02.2023,,5,26405
20.02.2023,,5,26410
19.02.2023,,95,26415
18.02.2023,,25,26510
18.02.2023,,15,26535
18.02.2023,,10,26550
18.02.2023,,5,26560
18.02.2023,,5,26565
14.02.2023,,20,26570
14.02.2023,,5,26590
13.02.2023,,50,26595
13.02.2023,,30,26645
12.02.2023,,15,26675
12.02.2023,,5,26690
11.02.2023,,5,26695
11.02.2023,,5,26700
08.02.2023,,340,26705
08.02.2023,,5,27045
07.02.2023,,45,27050
07.02.2023,,5,27095
06.02.2023,,15,27100
06.02.2023,,10,27115
05.02.2023,,25,27125
05.02.2023,,5,27150
04.02.2023,,220,27155
04.02.2023,,5,27375
31.01.2023,,5,27380
31.01.2023,,5,27385
31.01.2023,,,27390
31.01.2023,,,27390
31.01.2023,,,27390
31.01.2023,,,27390
31.01.2023,,,27390
31.01.2023,,,27390
31.01.2023,,,27390
31.01.2023,,,27390
28.01.2023,,160,27390
28.01.2023,,45,27550
28.01.2023,,10,27595
28.01.2023,,5,27605
25.01.2023,,10,27610
25.01.2023,,5,27620
25.01.2023,4999,,27625
24.01.2023,,5,22626
22.01.2023,,125,22631
22.01.2023,,30,22756
21.01.2023,,180,22786
21.01.2023,,50,22966
21.01.2023,,35,23016
21.01.2023,,5,23051
18.01.2023,,100,23056
18.01.2023,,5,23156
18.01.2023,,5,23161
18.01.2023,,5,23166
17.01.2023,,85,23171
16.01.2023,,5,23256
15.01.2023,,100,23261
15.01.2023,,40,23361
15.01.2023,,25,23401
15.01.2023,,10,23426
15.01.2023,,10,23436
14.01.2023,,340,23446
14.01.2023,,95,23786
14.01.2023,,60,23881
14.01.2023,,25,23941
14.01.2023,,20,23966
14.01.2023,,15,23986
14.01.2023,,15,24001
14.01.2023,,10,24016
11.01.2023,,60,24026
11.01.2023,,15,24086
11.01.2023,,10,24101
11.01.2023,,5,24111
10.01.2023,,25,24116
09.01.2023,,15,24141
08.01.2023,,35,24156
08.01.2023,,5,24191
07.01.2023,,125,24196
07.01.2023,,65,24321
07.01.2023,,20,24386
04.01.2023,,120,24406
31.12.2022,,5,24526
31.12.2022,,,24531
31.12.2022,,,24531
31.12.2022,,,24531
31.12.2022,,,24531
31.12.2022,,,24531
31.12.2022,,,24531
21.12.2022,,40,24531
21.12.2022,,15,24571
21.12.2022,4999,,24586
20.12.2022,,45,19587
19.12.2022,,10,19632
19.12.2022,,10,19642
18.12.2022,,340,19652
18.12.2022,,15,19992
18.12.2022,,10,20007
18.12.2022,,5,20017
17.12.2022,,10,20022
17.12.2022,,5,20032
17.12.2022,,5,20037
14.12.2022,,10,20042
13.12.2022,,20,20052
12.12.2022,,5,20072
11.12.2022,,15,20077
11.12.2022,,5,20092
11.12.2022,,5,20097
10.12.2022,,45,20102
07.12.2022,,5,20147
05.12.2022,,5,20152
04.12.2022,,55,20157
04.12.2022,,15,20212
03.12.2022,,60,20227
03.12.2022,,25,20287
30.11.2022,,5,20312
30.11.2022,,5,20317
30.11.2022,,,20322
30.11.2022,,,20322
30.11.2022,,,20322
30.11.2022,,,20322
30.11.2022,,,20322
30.11.2022,,,20322
28.11.2022,,5,20322
27.11.2022,,10,20327
26.11.2022,,95,20337
26.11.2022,,65,20432
26.11.2022,,15,20497
23.11.2022,6999,,20512
21.11.2022,,5,13513
20.11.2022,,330,13518
19.11.2022,,95,13848
19.11.2022,,15,13943
19.11.2022,,5,13958
19.11.2022,,5,13963
16.11.2022,,10,13968
15.11.2022,,105,13978
15.11.2022,,45,14083
15.11.2022,,20,14128
14.11.2022,,10,14148
14.11.2022,,10,14158
13.11.2022,,5,14168
13.11.2022,322,,14173
12.11.2022,,340,13851
12.11.2022,,320,14191
12.11.2022,,115,14511
09.11.2022,,5,14626
09.11.2022,,5,14631
08.11.2022,,5,14636
07.11.2022,,5,14641
05.11.2022,,90,14646
02.11.2022,,10,14736
02.11.2022,,5,14746
01.11.2022,,50,14751
01.11.2022,,5,14801
01.11.2022,,5,14806
31.10.2022,,5,14811
31.10.2022,,5,14816
31.10.2022,,,14821
31.10.2022,,,14821
31.10.2022,,,14821
31.10.2022,,,14821
31.10.2022,,,14821
31.10.2022,,,14821
29.10.2022,,15,14821
29.10.2022,,5,14836
29.10.2022,,5,14841
26.10.2022,,100,14846
26.10.2022,,45,14946
25.10.2022,,5,14991
25.10.2022,4999,,14996
24.10.2022,,10,9997
23.10.2022,,5,10007
22.10.2022,,30,10012
22.10.2022,,10,10042
18.10.2022,,80,10052
17.10.2022,,25,10132
17.10.2022,,5,10157
16.10.2022,,40,10162
15.10.2022,,600,10202
15.10.2022,,10,10802
15.10.2022,,5,10812
12.10.2022,,10,10817
11.10.2022,,340,10827
10.10.2022,,5,11167
09.10.2022,,5,11172
09.10.2022,,5,11177
08.10.2022,,15,11182
04.10.2022,,20,11197
04.10.2022,,5,11217
04.10.2022,,5,11222
03.10.2022,,30,11227
03.10.2022,,10,11257
02.10.2022,,200,11267
02.10.2022,,170,11467
02.10.2022,,100,11637
02.10.2022,,5,11737
01.10.2022,,205,11742
01.10.2022,,85,11947
01.10.2022,,60,12032
01.10.2022,,50,12092
28.09.2022,,10,12142
28.09.2022,,5,12152
28.09.2022,,5,12157
28.09.2022,,,12162
28.09.2022,,,12162
28.09.2022,,,12162
28.09.2022,,,12162
28.09.2022,,,12162
28.09.2022,,,12162
27.09.2022,,1160,12162
27.09.2022,,45,13322
27.09.2022,,5,13367
27.09.2022,,5,13372
26.09.2022,,5,13377
25.09.2022,,5,13382
25.09.2022,4999,,13387
24.09.2022,,20,8388
21.09.2022,,15,8408
20.09.2022,,5,8423
19.09.2022,,5,8428
18.09.2022,,65,8433
18.09.2022,,15,8498
17.09.2022,,20,8513
17.09.2022,,5,8533
17.09.2022,,5,8538
14.09.2022,,25,8543
14.09.2022,,5,8568
13.09.2022,,10,8573
13.09.2022,,5,8583
13.09.2022,,5,8588
12.09.2022,,10,8593
11.09.2022,,555,8603
11.09.2022,,340,9158
11.09.2022,,5,9498
11.09.2022,,5,9503
10.09.2022,,5,9508
07.09.2022,,50,9513
07.09.2022,,10,9563
07.09.2022,,5,9573
07.09.2022,,5,9578
06.09.2022,,5,9583
05.09.2022,,140,9588
05.09.2022,,5,9728
05.09.2022,,5,9733
04.09.2022,,35,9738
04.09.2022,,25,9773
04.09.2022,,5,9798
04.09.2022,,5,9803
03.09.2022,,70,9808
03.09.2022,,10,9878
03.09.2022,,5,9888
03.09.2022,,5,9893
31.08.2022,,5,9898
31.08.2022,,5,9903
31.08.2022,,,9908
31.08.2022,,,9908
31.08.2022,,,9908
31.08.2022,,,9908
31.08.2022,,,9908
30.08.2022,,5,9908
29.08.2022,,200,9913
29.08.2022,,100,10113
29.08.2022,,35,10213
29.08.2022,,30,10248
29.08.2022,,5,10278
29.08.2022,,5,10283
27.08.2022,,80,10288
27.08.2022,,35,10368
27.08.2022,,10,10403
24.08.2022,4999,,10413
22.08.2022,,30,5414
22.08.2022,,5,5444
21.08.2022,,5,5449
20.08.2022,,35,5454
17.08.2022,,5,5489
17.08.2022,,5,5494
15.08.2022,,5,5499
13.08.2022,,340,5504
31.07.2022,,5,5844
31.07.2022,,,5849
31.07.2022,,,5849
31.07.2022,,,5849
31.07.2022,,,5849
31.07.2022,,,5849
31.07.2022,,,5849
31.07.2022,,,5849
25.07.2022,4999,,5849
18.07.2022,,40,850
17.07.2022,,5,890
16.07.2022,,5,895
16.07.2022,,,900
13.07.2022,,100,900
10.07.2022,,,1000
09.07.2022,1000,,1000
04.07.2022,,,0